111111111
100K00001
10E00C001
10K0K0P01
1000K0EK1
111111111