111111111
1E0K00001
100H0P001
10K0KC001
1000K00K1
111111111