111111111
1E1KC0001
101C00101
10K0KP001
1000K01K1
111111111